...###..............
..#########.........
.###.....#..#....##.
##...@.##...####....
###....###..#...###.
..#..##...##......#.
.#......#.##.....#..
.#.##..#.##.......##
.#......#.##........
...###...........###
..#########....###..
.###.....#..#.......
##.........####.....
###....###..#.......
..#..##...##......##
.#......#.##...##..#
.#.##..#.##.........
.#......#.##........