..............
############..
..@.##........
..###.####....
........###...
..###...###...
......#####...
..............
..............
