..............
..............
..###...###...
..@...........
..###...###...
..............
..............
..............
